== Precheck runner ==
Host: 192.168.68.104  Port: 3306  User: migrate
Checks dir: /Users/balajin/Documents/GitHub/Mysql-to-MariaDB-Migration/sql/checks
Outdir: /Users/balajin/Documents/GitHub/Mysql-to-MariaDB-Migration/artifacts/precheck

---- mysql_version ----
8.4.8

---- innodb_settings ----
1	1

---- auth_plugins ----
migrate	%	caching_sha2_password
migrate	192.168.64.2	caching_sha2_password
packer	%	caching_sha2_password
root	localhost	caching_sha2_password

---- json_columns ----
testdb	orders_json	data_json	json

---- compression_encryption ----
(no rows)

---- engines_summary ----
PERFORMANCE_SCHEMA	113
InnoDB	46
CSV	2

---- schema_sizes ----
testdb	38.56
mysql	2.61
classicmodels	0.50
sys	0.02
information_schema	0.00
performance_schema	0.00

---- schema_charsets ----
classicmodels	latin1	latin1_swedish_ci
testdb	utf8mb4	utf8mb4_0900_ai_ci

---- mysql8_collations ----
testdb	orders_json	utf8mb4_0900_ai_ci

---- mysql8_column_collations ----
testdb	orders_json	product	utf8mb4_0900_ai_ci

---- sql_mode ----
ONLY_FULL_GROUP_BY,STRICT_TRANS_TABLES,NO_ZERO_IN_DATE,NO_ZERO_DATE,ERROR_FOR_DIVISION_BY_ZERO,NO_ENGINE_SUBSTITUTION

---- definers_inventory ----
(no rows)

---- partitioned_tables ----
(no rows)

---- active_plugins ----
ARCHIVE	ACTIVE
binlog	ACTIVE
BLACKHOLE	ACTIVE
caching_sha2_password	ACTIVE
CSV	ACTIVE
daemon_keyring_proxy_plugin	ACTIVE
InnoDB	ACTIVE
INNODB_BUFFER_PAGE	ACTIVE
INNODB_BUFFER_PAGE_LRU	ACTIVE
INNODB_BUFFER_POOL_STATS	ACTIVE
INNODB_CACHED_INDEXES	ACTIVE
INNODB_CMP	ACTIVE
INNODB_CMPMEM	ACTIVE
INNODB_CMPMEM_RESET	ACTIVE
INNODB_CMP_PER_INDEX	ACTIVE
INNODB_CMP_PER_INDEX_RESET	ACTIVE
INNODB_CMP_RESET	ACTIVE
INNODB_COLUMNS	ACTIVE
INNODB_FT_BEING_DELETED	ACTIVE
INNODB_FT_CONFIG	ACTIVE
INNODB_FT_DEFAULT_STOPWORD	ACTIVE
INNODB_FT_DELETED	ACTIVE
INNODB_FT_INDEX_CACHE	ACTIVE
INNODB_FT_INDEX_TABLE	ACTIVE
INNODB_INDEXES	ACTIVE
INNODB_METRICS	ACTIVE
INNODB_SESSION_TEMP_TABLESPACES	ACTIVE
INNODB_TABLES	ACTIVE
INNODB_TABLESPACES	ACTIVE
INNODB_TABLESTATS	ACTIVE
INNODB_TEMP_TABLE_INFO	ACTIVE
INNODB_TRX	ACTIVE
INNODB_VIRTUAL	ACTIVE
MEMORY	ACTIVE
MRG_MYISAM	ACTIVE
MyISAM	ACTIVE
mysqlx	ACTIVE
mysqlx_cache_cleaner	ACTIVE
ngram	ACTIVE
PERFORMANCE_SCHEMA	ACTIVE
sha256_password	ACTIVE
sha2_cache_cleaner	ACTIVE
TempTable	ACTIVE

Precheck complete.
TSV outputs: /Users/balajin/Documents/GitHub/Mysql-to-MariaDB-Migration/artifacts/precheck/*.tsv
